James	James, James, bo-bames, Banana-fana fo-fames Fee-fy-mo-mames James!
Mary	Mary, Mary, bo-bary, Banana-fana fo-fary Fee-fy-mo-ary Mary!
John	John, John, bo-bohn, Banana-fana fo-fohn Fee-fy-mo-mohn John!
Patricia	Patricia, Patricia, bo-batricia, Banana-fana fo-fatricia Fee-fy-mo-matricia Patricia!
Robert	Robert, Robert, bo-bobert, Banana-fana fo-fobert Fee-fy-mo-mobert Robert!
Jennifer	Jennifer, Jennifer, bo-bennifer, Banana-fana fo-fennifer Fee-fy-mo-mennifer Jennifer!
Michael	Michael, Michael, bo-bichael, Banana-fana fo-fichael Fee-fy-mo-ichael Michael!
Elizabeth	Elizabeth, Elizabeth, bo-belizabeth, Banana-fana fo-felizabeth Fee-fy-mo-melizabeth Elizabeth!
William	William, William, bo-billiam, Banana-fana fo-filliam Fee-fy-mo-milliam William!
Linda	Linda, Linda, bo-binda, Banana-fana fo-finda Fee-fy-mo-minda Linda!
David	David, David, bo-bavid, Banana-fana fo-favid Fee-fy-mo-mavid David!
Barbara	Barbara, Barbara, bo-arbara, Banana-fana fo-farbara Fee-fy-mo-marbara Barbara!
Richard	Richard, Richard, bo-bichard, Banana-fana fo-fichard Fee-fy-mo-michard Richard!
Susan	Susan, Susan, bo-busan, Banana-fana fo-fusan Fee-fy-mo-musan Susan!
Joseph	Joseph, Joseph, bo-boseph, Banana-fana fo-foseph Fee-fy-mo-moseph Joseph!
Margaret	Margaret, Margaret, bo-bargaret, Banana-fana fo-fargaret Fee-fy-mo-argaret Margaret!
Charles	Charles, Charles, bo-bharles, Banana-fana fo-fharles Fee-fy-mo-mharles Charles!
Jessica	Jessica, Jessica, bo-bessica, Banana-fana fo-fessica Fee-fy-mo-messica Jessica!
Thomas	Thomas, Thomas, bo-bhomas, Banana-fana fo-fhomas Fee-fy-mo-mhomas Thomas!
Sarah	Sarah, Sarah, bo-barah, Banana-fana fo-farah Fee-fy-mo-marah Sarah!
Christopher	Christopher, Christopher, bo-bhristopher, Banana-fana fo-fhristopher Fee-fy-mo-mhristopher Christopher!
Dorothy	Dorothy, Dorothy, bo-borothy, Banana-fana fo-forothy Fee-fy-mo-morothy Dorothy!
Daniel	Daniel, Daniel, bo-baniel, Banana-fana fo-faniel Fee-fy-mo-maniel Daniel!
Karen	Karen, Karen, bo-baren, Banana-fana fo-faren Fee-fy-mo-maren Karen!
Matthew	Matthew, Matthew, bo-batthew, Banana-fana fo-fatthew Fee-fy-mo-atthew Matthew!
Nancy	Nancy, Nancy, bo-bancy, Banana-fana fo-fancy Fee-fy-mo-mancy Nancy!
Donald	Donald, Donald, bo-bonald, Banana-fana fo-fonald Fee-fy-mo-monald Donald!
Betty	Betty, Betty, bo-etty, Banana-fana fo-fetty Fee-fy-mo-metty Betty!
Anthony	Anthony, Anthony, bo-banthony, Banana-fana fo-fanthony Fee-fy-mo-manthony Anthony!
Lisa	Lisa, Lisa, bo-bisa, Banana-fana fo-fisa Fee-fy-mo-misa Lisa!
Mark	Mark, Mark, bo-bark, Banana-fana fo-fark Fee-fy-mo-ark Mark!
Sandra	Sandra, Sandra, bo-bandra, Banana-fana fo-fandra Fee-fy-mo-mandra Sandra!
Paul	Paul, Paul, bo-baul, Banana-fana fo-faul Fee-fy-mo-maul Paul!
Ashley	Ashley, Ashley, bo-bashley, Banana-fana fo-fashley Fee-fy-mo-mashley Ashley!
Steven	Steven, Steven, bo-beven, Banana-fana fo-feven Fee-fy-mo-meven Steven!
Kimberly	Kimberly, Kimberly, bo-bimberly, Banana-fana fo-fimberly Fee-fy-mo-mimberly Kimberly!
George	George, George, bo-beorge, Banana-fana fo-feorge Fee-fy-mo-meorge George!
Donna	Donna, Donna, bo-bonna, Banana-fana fo-fonna Fee-fy-mo-monna Donna!
Kenneth	Kenneth, Kenneth, bo-benneth, Banana-fana fo-fenneth Fee-fy-mo-menneth Kenneth!
Helen	Helen, Helen, bo-belen, Banana-fana fo-felen Fee-fy-mo-melen Helen!
Andrew	Andrew, Andrew, bo-bandrew, Banana-fana fo-fandrew Fee-fy-mo-mandrew Andrew!
Carol	Carol, Carol, bo-barol, Banana-fana fo-farol Fee-fy-mo-marol Carol!
Edward	Edward, Edward, bo-bedward, Banana-fana fo-fedward Fee-fy-mo-medward Edward!
Michelle	Michelle, Michelle, bo-bichelle, Banana-fana fo-fichelle Fee-fy-mo-ichelle Michelle!
Joshua	Joshua, Joshua, bo-boshua, Banana-fana fo-foshua Fee-fy-mo-moshua Joshua!
Emily	Emily, Emily, bo-bemily, Banana-fana fo-femily Fee-fy-mo-memily Emily!
Brian	Brian, Brian, bo-rian, Banana-fana fo-frian Fee-fy-mo-mrian Brian!
Amanda	Amanda, Amanda, bo-bamanda, Banana-fana fo-famanda Fee-fy-mo-mamanda Amanda!
Kevin	Kevin, Kevin, bo-bevin, Banana-fana fo-fevin Fee-fy-mo-mevin Kevin!
Melissa	Melissa, Melissa, bo-belissa, Banana-fana fo-felissa Fee-fy-mo-elissa Melissa!
Ronald	Ronald, Ronald, bo-bonald, Banana-fana fo-fonald Fee-fy-mo-monald Ronald!
Deborah	Deborah, Deborah, bo-beborah, Banana-fana fo-feborah Fee-fy-mo-meborah Deborah!
Timothy	Timothy, Timothy, bo-bimothy, Banana-fana fo-fimothy Fee-fy-mo-mimothy Timothy!
Laura	Laura, Laura, bo-baura, Banana-fana fo-faura Fee-fy-mo-maura Laura!
Jason	Jason, Jason, bo-bason, Banana-fana fo-fason Fee-fy-mo-mason Jason!
Stephanie	Stephanie, Stephanie, bo-bephanie, Banana-fana fo-fephanie Fee-fy-mo-mephanie Stephanie!
Jeffrey	Jeffrey, Jeffrey, bo-beffrey, Banana-fana fo-feffrey Fee-fy-mo-meffrey Jeffrey!
Rebecca	Rebecca, Rebecca, bo-bebecca, Banana-fana fo-febecca Fee-fy-mo-mebecca Rebecca!
Ryan	Ryan, Ryan, bo-byan, Banana-fana fo-fyan Fee-fy-mo-myan Ryan!
Sharon	Sharon, Sharon, bo-bharon, Banana-fana fo-fharon Fee-fy-mo-mharon Sharon!
Gary	Gary, Gary, bo-bary, Banana-fana fo-fary Fee-fy-mo-mary Gary!
Cynthia	Cynthia, Cynthia, bo-bynthia, Banana-fana fo-fynthia Fee-fy-mo-mynthia Cynthia!
Nicholas	Nicholas, Nicholas, bo-bicholas, Banana-fana fo-ficholas Fee-fy-mo-micholas Nicholas!
Kathleen	Kathleen, Kathleen, bo-bathleen, Banana-fana fo-fathleen Fee-fy-mo-mathleen Kathleen!
Eric	Eric, Eric, bo-beric, Banana-fana fo-feric Fee-fy-mo-meric Eric!
Anna	Anna, Anna, bo-banna, Banana-fana fo-fanna Fee-fy-mo-manna Anna!
Jacob	Jacob, Jacob, bo-bacob, Banana-fana fo-facob Fee-fy-mo-macob Jacob!
Shirley	Shirley, Shirley, bo-bhirley, Banana-fana fo-fhirley Fee-fy-mo-mhirley Shirley!
Stephen	Stephen, Stephen, bo-bephen, Banana-fana fo-fephen Fee-fy-mo-mephen Stephen!
Ruth	Ruth, Ruth, bo-buth, Banana-fana fo-futh Fee-fy-mo-muth Ruth!
Jonathan	Jonathan, Jonathan, bo-bonathan, Banana-fana fo-fonathan Fee-fy-mo-monathan Jonathan!
Amy	Amy, Amy, bo-bamy, Banana-fana fo-famy Fee-fy-mo-mamy Amy!
Larry	Larry, Larry, bo-barry, Banana-fana fo-farry Fee-fy-mo-marry Larry!
Angela	Angela, Angela, bo-bangela, Banana-fana fo-fangela Fee-fy-mo-mangela Angela!
Frank	Frank, Frank, bo-brank, Banana-fana fo-rank Fee-fy-mo-mrank Frank!
Brenda	Brenda, Brenda, bo-renda, Banana-fana fo-frenda Fee-fy-mo-mrenda Brenda!
Scott	Scott, Scott, bo-bcott, Banana-fana fo-fcott Fee-fy-mo-mcott Scott!
Virginia	Virginia, Virginia, bo-birginia, Banana-fana fo-firginia Fee-fy-mo-mirginia Virginia!
Justin	Justin, Justin, bo-bustin, Banana-fana fo-fustin Fee-fy-mo-mustin Justin!
Pamela	Pamela, Pamela, bo-bamela, Banana-fana fo-famela Fee-fy-mo-mamela Pamela!
Brandon	Brandon, Brandon, bo-randon, Banana-fana fo-frandon Fee-fy-mo-mrandon Brandon!
Catherine	Catherine, Catherine, bo-batherine, Banana-fana fo-fatherine Fee-fy-mo-matherine Catherine!
Raymond	Raymond, Raymond, bo-baymond, Banana-fana fo-faymond Fee-fy-mo-maymond Raymond!
Katherine	Katherine, Katherine, bo-batherine, Banana-fana fo-fatherine Fee-fy-mo-matherine Katherine!
Gregory	Gregory, Gregory, bo-bregory, Banana-fana fo-fregory Fee-fy-mo-mregory Gregory!
Nicole	Nicole, Nicole, bo-bicole, Banana-fana fo-ficole Fee-fy-mo-micole Nicole!
Samuel	Samuel, Samuel, bo-bamuel, Banana-fana fo-famuel Fee-fy-mo-mamuel Samuel!
Christine	Christine, Christine, bo-bhristine, Banana-fana fo-fhristine Fee-fy-mo-mhristine Christine!
Benjamin	Benjamin, Benjamin, bo-enjamin, Banana-fana fo-fenjamin Fee-fy-mo-menjamin Benjamin!
Samantha	Samantha, Samantha, bo-bamantha, Banana-fana fo-famantha Fee-fy-mo-mamantha Samantha!
Patrick	Patrick, Patrick, bo-batrick, Banana-fana fo-fatrick Fee-fy-mo-matrick Patrick!
Janet	Janet, Janet, bo-banet, Banana-fana fo-fanet Fee-fy-mo-manet Janet!
Jack	Jack, Jack, bo-back, Banana-fana fo-fack Fee-fy-mo-mack Jack!
Debra	Debra, Debra, bo-bebra, Banana-fana fo-febra Fee-fy-mo-mebra Debra!
Dennis	Dennis, Dennis, bo-bennis, Banana-fana fo-fennis Fee-fy-mo-mennis Dennis!
Carolyn	Carolyn, Carolyn, bo-barolyn, Banana-fana fo-farolyn Fee-fy-mo-marolyn Carolyn!
Alexander	Alexander, Alexander, bo-balexander, Banana-fana fo-falexander Fee-fy-mo-malexander Alexander!
Rachel	Rachel, Rachel, bo-bachel, Banana-fana fo-fachel Fee-fy-mo-machel Rachel!
Jerry	Jerry, Jerry, bo-berry, Banana-fana fo-ferry Fee-fy-mo-merry Jerry!
Heather	Heather, Heather, bo-beather, Banana-fana fo-feather Fee-fy-mo-meather Heather!
Tyler	Tyler, Tyler, bo-byler, Banana-fana fo-fyler Fee-fy-mo-myler Tyler!
Maria	Maria, Maria, bo-baria, Banana-fana fo-faria Fee-fy-mo-aria Maria!
Henry	Henry, Henry, bo-benry, Banana-fana fo-fenry Fee-fy-mo-menry Henry!
Diane	Diane, Diane, bo-biane, Banana-fana fo-fiane Fee-fy-mo-miane Diane!
Douglas	Douglas, Douglas, bo-bouglas, Banana-fana fo-fouglas Fee-fy-mo-mouglas Douglas!
Julie	Julie, Julie, bo-bulie, Banana-fana fo-fulie Fee-fy-mo-mulie Julie!
Aaron	Aaron, Aaron, bo-baron, Banana-fana fo-faron Fee-fy-mo-maron Aaron!
Joyce	Joyce, Joyce, bo-boyce, Banana-fana fo-foyce Fee-fy-mo-moyce Joyce!
Peter	Peter, Peter, bo-beter, Banana-fana fo-feter Fee-fy-mo-meter Peter!
Emma	Emma, Emma, bo-bemma, Banana-fana fo-femma Fee-fy-mo-memma Emma!
Jose	Jose, Jose, bo-bose, Banana-fana fo-fose Fee-fy-mo-mose Jose!
Frances	Frances, Frances, bo-brances, Banana-fana fo-rances Fee-fy-mo-mrances Frances!
Walter	Walter, Walter, bo-balter, Banana-fana fo-falter Fee-fy-mo-malter Walter!
Evelyn	Evelyn, Evelyn, bo-bevelyn, Banana-fana fo-fevelyn Fee-fy-mo-mevelyn Evelyn!
Adam	Adam, Adam, bo-badam, Banana-fana fo-fadam Fee-fy-mo-madam Adam!
Joan	Joan, Joan, bo-boan, Banana-fana fo-foan Fee-fy-mo-moan Joan!
Zachary	Zachary, Zachary, bo-bachary, Banana-fana fo-fachary Fee-fy-mo-machary Zachary!
Martha	Martha, Martha, bo-bartha, Banana-fana fo-fartha Fee-fy-mo-artha Martha!
Nathan	Nathan, Nathan, bo-bathan, Banana-fana fo-fathan Fee-fy-mo-mathan Nathan!
Christina	Christina, Christina, bo-bhristina, Banana-fana fo-fhristina Fee-fy-mo-mhristina Christina!
Harold	Harold, Harold, bo-barold, Banana-fana fo-farold Fee-fy-mo-marold Harold!
Kelly	Kelly, Kelly, bo-belly, Banana-fana fo-felly Fee-fy-mo-melly Kelly!
Kyle	Kyle, Kyle, bo-byle, Banana-fana fo-fyle Fee-fy-mo-myle Kyle!
Lauren	Lauren, Lauren, bo-bauren, Banana-fana fo-fauren Fee-fy-mo-mauren Lauren!
Carl	Carl, Carl, bo-barl, Banana-fana fo-farl Fee-fy-mo-marl Carl!
Victoria	Victoria, Victoria, bo-bictoria, Banana-fana fo-fictoria Fee-fy-mo-mictoria Victoria!
Arthur	Arthur, Arthur, bo-barthur, Banana-fana fo-farthur Fee-fy-mo-marthur Arthur!
Judith	Judith, Judith, bo-budith, Banana-fana fo-fudith Fee-fy-mo-mudith Judith!
Gerald	Gerald, Gerald, bo-berald, Banana-fana fo-ferald Fee-fy-mo-merald Gerald!
Alice	Alice, Alice, bo-balice, Banana-fana fo-falice Fee-fy-mo-malice Alice!
Roger	Roger, Roger, bo-boger, Banana-fana fo-foger Fee-fy-mo-moger Roger!
Ann	Ann, Ann, bo-bann, Banana-fana fo-fann Fee-fy-mo-mann Ann!
Keith	Keith, Keith, bo-beith, Banana-fana fo-feith Fee-fy-mo-meith Keith!
Cheryl	Cheryl, Cheryl, bo-bheryl, Banana-fana fo-fheryl Fee-fy-mo-mheryl Cheryl!
Lawrence	Lawrence, Lawrence, bo-bawrence, Banana-fana fo-fawrence Fee-fy-mo-mawrence Lawrence!
Jean	Jean, Jean, bo-bean, Banana-fana fo-fean Fee-fy-mo-mean Jean!
Jeremy	Jeremy, Jeremy, bo-beremy, Banana-fana fo-feremy Fee-fy-mo-meremy Jeremy!
Doris	Doris, Doris, bo-boris, Banana-fana fo-foris Fee-fy-mo-moris Doris!
Terry	Terry, Terry, bo-berry, Banana-fana fo-ferry Fee-fy-mo-merry Terry!
Megan	Megan, Megan, bo-began, Banana-fana fo-fegan Fee-fy-mo-egan Megan!
Albert	Albert, Albert, bo-balbert, Banana-fana fo-falbert Fee-fy-mo-malbert Albert!
Marie	Marie, Marie, bo-barie, Banana-fana fo-farie Fee-fy-mo-arie Marie!
Joe	Joe, Joe, bo-boe, Banana-fana fo-foe Fee-fy-mo-moe Joe!
Andrea	Andrea, Andrea, bo-bandrea, Banana-fana fo-fandrea Fee-fy-mo-mandrea Andrea!
Sean	Sean, Sean, bo-bean, Banana-fana fo-fean Fee-fy-mo-mean Sean!
Kathryn	Kathryn, Kathryn, bo-bathryn, Banana-fana fo-fathryn Fee-fy-mo-mathryn Kathryn!
Willie	Willie, Willie, bo-billie, Banana-fana fo-fillie Fee-fy-mo-millie Willie!
Jacqueline	Jacqueline, Jacqueline, bo-bacqueline, Banana-fana fo-facqueline Fee-fy-mo-macqueline Jacqueline!
Christian	Christian, Christian, bo-bhristian, Banana-fana fo-fhristian Fee-fy-mo-mhristian Christian!
Gloria	Gloria, Gloria, bo-bloria, Banana-fana fo-floria Fee-fy-mo-mloria Gloria!
Jesse	Jesse, Jesse, bo-besse, Banana-fana fo-fesse Fee-fy-mo-messe Jesse!
Teresa	Teresa, Teresa, bo-beresa, Banana-fana fo-feresa Fee-fy-mo-meresa Teresa!
Austin	Austin, Austin, bo-baustin, Banana-fana fo-faustin Fee-fy-mo-maustin Austin!
Sara	Sara, Sara, bo-bara, Banana-fana fo-fara Fee-fy-mo-mara Sara!
Billy	Billy, Billy, bo-illy, Banana-fana fo-filly Fee-fy-mo-milly Billy!
Janice	Janice, Janice, bo-banice, Banana-fana fo-fanice Fee-fy-mo-manice Janice!
Bruce	Bruce, Bruce, bo-ruce, Banana-fana fo-fruce Fee-fy-mo-mruce Bruce!
Hannah	Hannah, Hannah, bo-bannah, Banana-fana fo-fannah Fee-fy-mo-mannah Hannah!
Ralph	Ralph, Ralph, bo-balph, Banana-fana fo-falph Fee-fy-mo-malph Ralph!
Julia	Julia, Julia, bo-bulia, Banana-fana fo-fulia Fee-fy-mo-mulia Julia!
Bryan	Bryan, Bryan, bo-ryan, Banana-fana fo-fryan Fee-fy-mo-mryan Bryan!
Rose	Rose, Rose, bo-bose, Banana-fana fo-fose Fee-fy-mo-mose Rose!
Ethan	Ethan, Ethan, bo-bethan, Banana-fana fo-fethan Fee-fy-mo-methan Ethan!
Theresa	Theresa, Theresa, bo-bheresa, Banana-fana fo-fheresa Fee-fy-mo-mheresa Theresa!
Roy	Roy, Roy, bo-boy, Banana-fana fo-foy Fee-fy-mo-moy Roy!
Grace	Grace, Grace, bo-brace, Banana-fana fo-frace Fee-fy-mo-mrace Grace!
Eugene	Eugene, Eugene, bo-bugene, Banana-fana fo-fugene Fee-fy-mo-mugene Eugene!
Judy	Judy, Judy, bo-budy, Banana-fana fo-fudy Fee-fy-mo-mudy Judy!
Jordan	Jordan, Jordan, bo-bordan, Banana-fana fo-fordan Fee-fy-mo-mordan Jordan!
Beverly	Beverly, Beverly, bo-everly, Banana-fana fo-feverly Fee-fy-mo-meverly Beverly!
Louis	Louis, Louis, bo-bouis, Banana-fana fo-fouis Fee-fy-mo-mouis Louis!
Olivia	Olivia, Olivia, bo-bolivia, Banana-fana fo-folivia Fee-fy-mo-molivia Olivia!
Wayne	Wayne, Wayne, bo-bayne, Banana-fana fo-fayne Fee-fy-mo-mayne Wayne!
Denise	Denise, Denise, bo-benise, Banana-fana fo-fenise Fee-fy-mo-menise Denise!
Alan	Alan, Alan, bo-balan, Banana-fana fo-falan Fee-fy-mo-malan Alan!
Marilyn	Marilyn, Marilyn, bo-barilyn, Banana-fana fo-farilyn Fee-fy-mo-arilyn Marilyn!
Harry	Harry, Harry, bo-barry, Banana-fana fo-farry Fee-fy-mo-marry Harry!
Amber	Amber, Amber, bo-bamber, Banana-fana fo-famber Fee-fy-mo-mamber Amber!
Russell	Russell, Russell, bo-bussell, Banana-fana fo-fussell Fee-fy-mo-mussell Russell!
Danielle	Danielle, Danielle, bo-banielle, Banana-fana fo-fanielle Fee-fy-mo-manielle Danielle!
Juan	Juan, Juan, bo-buan, Banana-fana fo-fuan Fee-fy-mo-muan Juan!
Brittany	Brittany, Brittany, bo-rittany, Banana-fana fo-frittany Fee-fy-mo-mrittany Brittany!
Dylan	Dylan, Dylan, bo-bylan, Banana-fana fo-fylan Fee-fy-mo-mylan Dylan!
Diana	Diana, Diana, bo-biana, Banana-fana fo-fiana Fee-fy-mo-miana Diana!
Randy	Randy, Randy, bo-bandy, Banana-fana fo-fandy Fee-fy-mo-mandy Randy!
Mildred	Mildred, Mildred, bo-bildred, Banana-fana fo-fildred Fee-fy-mo-ildred Mildred!
Philip	Philip, Philip, bo-bhilip, Banana-fana fo-fhilip Fee-fy-mo-mhilip Philip!
Jane	Jane, Jane, bo-bane, Banana-fana fo-fane Fee-fy-mo-mane Jane!
Vincent	Vincent, Vincent, bo-bincent, Banana-fana fo-fincent Fee-fy-mo-mincent Vincent!
Madison	Madison, Madison, bo-badison, Banana-fana fo-fadison Fee-fy-mo-adison Madison!
Noah	Noah, Noah, bo-boah, Banana-fana fo-foah Fee-fy-mo-moah Noah!
Lori	Lori, Lori, bo-bori, Banana-fana fo-fori Fee-fy-mo-mori Lori!
Bobby	Bobby, Bobby, bo-obby, Banana-fana fo-fobby Fee-fy-mo-mobby Bobby!
Tiffany	Tiffany, Tiffany, bo-biffany, Banana-fana fo-fiffany Fee-fy-mo-miffany Tiffany!
Howard	Howard, Howard, bo-boward, Banana-fana fo-foward Fee-fy-mo-moward Howard!
Kathy	Kathy, Kathy, bo-bathy, Banana-fana fo-fathy Fee-fy-mo-mathy Kathy!
Gabriel	Gabriel, Gabriel, bo-babriel, Banana-fana fo-fabriel Fee-fy-mo-mabriel Gabriel!
Tammy	Tammy, Tammy, bo-bammy, Banana-fana fo-fammy Fee-fy-mo-mammy Tammy!
Johnny	Johnny, Johnny, bo-bohnny, Banana-fana fo-fohnny Fee-fy-mo-mohnny Johnny!
Kayla	Kayla, Kayla, bo-bayla, Banana-fana fo-fayla Fee-fy-mo-mayla Kayla!
